α=a
β=b
γ=g
δ=d
ε=e
ζ=z
η=h
θ=th
ι=i
κ=k
λ=l
μ=m
ν=n
ξ=x
ο=o
π=p
ρ=r
ς=c
σ=s
τ=t
υ=u
φ=ph
χ=ch
ψ=ps
ω=o
ώ=o
Α=A
Β=B
Γ=G
Δ=D
Ε=E
Ζ=Z
Η=H
Θ=Th
Ι=I
Κ=K
Λ=L
Μ=M
Ν=N
Ξ=X
Ο=O
Π=P
Ρ=R
Σ=S
Τ=T
Υ=U
Φ=Ph
Χ=Ch
Ψ=Ps
Ω=O